,reporting_date,daily_cases,cumulative_cases,daily_deaths,cumulative_deaths
0,08-03-2020,2,4,0,0
1,09-03-2020,10,14,0,0
2,10-03-2020,0,14,0,0
3,11-03-2020,5,19,0,0
4,12-03-2020,4,23,0,0
5,13-03-2020,6,29,0,0
6,14-03-2020,10,39,0,0
7,15-03-2020,17,56,0,0
8,16-03-2020,18,74,0,0
9,17-03-2020,23,97,0,0
10,18-03-2020,22,119,0,0
11,19-03-2020,27,146,1,1
12,20-03-2020,49,195,0,1
13,21-03-2020,31,226,0,1
14,22-03-2020,33,259,0,1
15,23-03-2020,42,301,0,1
16,24-03-2020,57,358,1,2
17,25-03-2020,61,419,0,2
18,26-03-2020,67,486,0,2
19,27-03-2020,56,542,0,2
20,28-03-2020,79,621,0,2
21,29-03-2020,40,661,1,3
22,30-03-2020,29,690,5,8
23,31-03-2020,64,754,1,9
24,01-04-2020,117,871,2,11
25,02-04-2020,97,968,2,13
26,03-04-2020,107,1075,5,18
27,04-04-2020,106,1181,2,20
28,05-04-2020,69,1250,3,23
29,06-04-2020,98,1348,1,24
30,07-04-2020,25,1373,2,26
31,08-04-2020,50,1423,3,29
32,09-04-2020,28,1451,3,32
33,10-04-2020,49,1500,7,39
34,11-04-2020,69,1569,1,40
35,12-04-2020,82,1651,4,44
36,13-04-2020,81,1732,2,46
37,14-04-2020,138,1870,2,48
38,15-04-2020,126,1996,0,48
39,16-04-2020,162,2158,2,50
40,17-04-2020,239,2397,0,50
41,18-04-2020,165,2562,1,51
42,19-04-2020,241,2803,4,55
43,20-04-2020,105,2908,4,59
44,21-04-2020,187,3095,2,61
45,22-04-2020,306,3401,5,66
46,23-04-2020,319,3720,2,68
47,24-04-2020,297,4017,4,72
48,25-04-2020,215,4232,1,73
49,26-04-2020,243,4475,0,73
50,27-04-2020,216,4691,2,75
51,28-04-2020,159,4850,5,80
52,29-04-2020,315,5165,7,87
53,30-04-2020,190,5355,2,89
54,01-05-2020,218,5573,3,92
55,02-05-2020,96,5669,2,94
56,03-05-2020,93,5762,1,95
57,04-05-2020,74,5836,9,104
58,05-05-2020,57,5893,2,106
59,06-05-2020,70,5963,6,112
60,07-05-2020,54,6017,2,114
61,08-05-2020,81,6098,1,115
62,09-05-2020,59,6157,1,116
63,10-05-2020,96,6253,1,117
64,11-05-2020,47,6300,0,117
65,12-05-2020,45,6345,1,118
66,13-05-2020,62,6407,2,120
67,14-05-2020,50,6457,1,121
68,15-05-2020,57,6514,4,125
69,16-05-2020,72,6586,1,126
70,17-05-2020,57,6643,1,127
71,18-05-2020,39,6682,1,128
72,19-05-2020,33,6715,0,128
73,20-05-2020,19,6734,0,128
74,21-05-2020,33,6767,4,132
75,22-05-2020,32,6799,2,134
76,23-05-2020,18,6817,1,135
77,24-05-2020,42,6859,0,135
78,25-05-2020,19,6878,3,138
79,26-05-2020,22,6900,1,139
80,27-05-2020,25,6925,2,141
81,28-05-2020,29,6954,2,143
82,29-05-2020,24,6978,0,143
83,30-05-2020,14,6992,0,143
84,31-05-2020,18,7010,0,143
85,01-06-2020,34,7044,0,143
86,02-06-2020,13,7057,0,143
87,03-06-2020,19,7076,2,145
88,04-06-2020,15,7091,1,146
89,05-06-2020,7,7098,0,146
90,06-06-2020,40,7138,0,146
91,07-06-2020,0,7138,0,146
92,08-06-2020,64,7202,2,148
93,09-06-2020,27,7229,1,149
94,10-06-2020,47,7276,0,149
95,11-06-2020,40,7316,0,149
96,12-06-2020,30,7346,0,149
97,13-06-2020,37,7383,1,150
98,14-06-2020,50,7433,0,150
99,15-06-2020,14,7447,1,151
100,16-06-2020,35,7482,0,151
101,17-06-2020,48,7530,0,151
102,18-06-2020,49,7579,1,152
103,19-06-2020,46,7625,0,152
104,20-06-2020,48,7673,0,152
105,21-06-2020,31,7704,0,152
106,22-06-2020,32,7736,1,153
107,23-06-2020,45,7781,0,153
108,24-06-2020,44,7825,0,153
109,25-06-2020,26,7851,1,154
110,26-06-2020,37,7888,0,154
111,27-06-2020,69,7957,0,154
112,28-06-2020,39,7996,0,154
113,29-06-2020,71,8067,0,154
114,30-06-2020,41,8108,0,154
115,01-07-2020,0,8108,0,154
116,02-07-2020,94,8202,1,155
117,03-07-2020,57,8259,0,155
118,04-07-2020,0,8259,0,155
119,05-07-2020,0,8259,0,155
120,06-07-2020,130,8389,0,155
121,07-07-2020,47,8436,2,157
122,08-07-2020,46,8482,1,158
123,09-07-2020,37,8519,2,160
124,10-07-2020,77,8596,0,160
125,11-07-2020,0,8596,0,160
126,12-07-2020,0,8596,0,160
127,13-07-2020,230,8826,1,161
128,14-07-2020,86,8912,2,163
129,15-07-2020,82,8994,0,163
130,16-07-2020,120,9114,2,165
131,17-07-2020,105,9219,2,167
132,18-07-2020,0,9219,0,167
133,19-07-2020,0,9219,0,167
134,20-07-2020,368,9587,3,170
135,21-07-2020,141,9728,1,171
136,22-07-2020,133,9861,2,173
137,23-07-2020,112,9973,2,175
138,24-07-2020,111,10084,2,177
139,25-07-2020,0,10084,0,177
140,26-07-2020,0,10084,0,177
141,27-07-2020,303,10387,8,185
142,28-07-2020,79,10466,2,187
143,29-07-2020,133,10599,3,190
144,30-07-2020,113,10712,5,195
145,31-07-2020,127,10839,1,196
146,01-08-2020,0,10839,0,196
147,02-08-2020,0,10839,0,196
148,03-08-2020,0,10839,0,196
149,04-08-2020,305,11144,5,201
150,05-08-2020,94,11238,2,203
151,06-08-2020,56,11294,2,205
152,07-08-2020,136,11430,3,208
153,08-08-2020,0,11430,0,208
154,09-08-2020,0,11430,0,208
155,10-08-2020,257,11687,5,213
156,11-08-2020,85,11772,3,216
157,12-08-2020,121,11893,1,217
158,13-08-2020,76,11969,3,220
159,14-08-2020,84,12053,1,221
160,15-08-2020,0,12053,0,221
161,16-08-2020,0,12053,0,221
162,17-08-2020,277,12330,3,224
163,18-08-2020,89,12419,1,225
164,19-08-2020,82,12501,2,227
165,20-08-2020,103,12604,1,228
166,21-08-2020,144,12748,2,230
167,22-08-2020,0,12748,0,230
168,23-08-2020,0,12748,0,230
169,24-08-2020,258,13006,4,234
170,25-08-2020,77,13083,1,235
171,26-08-2020,127,13210,0,235
172,27-08-2020,108,13318,2,237
173,28-08-2020,158,13476,0,237
174,29-08-2020,0,13476,0,237
175,30-08-2020,0,13476,0,237
176,31-08-2020,426,13902,2,239
177,01-09-2020,164,14066,2,241
178,02-09-2020,114,14180,1,242
179,03-09-2020,130,14310,0,242
180,04-09-2020,164,14474,0,242
181,05-09-2020,0,14474,0,242
182,06-09-2020,0,14474,0,242
183,07-09-2020,0,14474,0,242
184,08-09-2020,619,15093,5,247
185,09-09-2020,98,15191,1,248
186,10-09-2020,113,15304,5,253
187,11-09-2020,111,15415,0,253
188,12-09-2020,0,15415,0,253
189,13-09-2020,0,15415,0,253
190,14-09-2020,418,15833,1,254
191,15-09-2020,124,15957,0,254
192,16-09-2020,171,16128,0,254
193,17-09-2020,146,16274,0,254
194,18-09-2020,107,16381,1,255
195,19-09-2020,0,16381,0,255
196,20-09-2020,0,16381,0,255
197,21-09-2020,358,16739,1,256
198,22-09-2020,150,16889,2,258
199,23-09-2020,143,17032,2,260
200,24-09-2020,158,17190,1,261
201,25-09-2020,153,17343,0,261
202,26-09-2020,0,17343,0,261
203,27-09-2020,0,17343,0,261
204,28-09-2020,406,17749,4,265
205,29-09-2020,160,17909,1,266
206,30-09-2020,153,18062,1,267
207,01-10-2020,173,18235,2,269
208,02-10-2020,122,18357,3,272
209,03-10-2020,0,18357,0,272
210,04-10-2020,0,18357,0,272
211,05-10-2020,576,18933,8,280
212,06-10-2020,275,19208,1,281
213,07-10-2020,142,19350,0,281
214,08-10-2020,362,19712,1,282
215,09-10-2020,277,19989,0,282
216,10-10-2020,0,19989,0,282
217,11-10-2020,0,19989,0,282
218,12-10-2020,0,19989,0,282
219,13-10-2020,967,20956,4,286
220,14-10-2020,243,21199,1,287
221,15-10-2020,244,21443,1,288
222,16-10-2020,332,21775,0,288
223,17-10-2020,0,21775,0,288
224,18-10-2020,0,21775,0,288
225,19-10-2020,898,22673,4,292
226,20-10-2020,323,22996,1,293
227,21-10-2020,406,23402,3,296
228,22-10-2020,427,23829,0,296
229,23-10-2020,432,24261,4,300
230,24-10-2020,0,24261,0,300
231,25-10-2020,0,24261,0,300
232,26-10-2020,1472,25733,7,307
233,27-10-2020,422,26155,2,309
234,28-10-2020,410,26565,4,313
235,29-10-2020,477,27042,5,318
236,30-10-2020,622,27664,5,323
237,31-10-2020,0,27664,0,323
238,01-11-2020,0,27664,0,323
239,02-11-2020,0,27664,0,323
240,03-11-2020,2268,29932,15,338
241,04-11-2020,515,30447,5,343
242,05-11-2020,0,30447,0,343
243,06-11-2020,1411,31858,9,352
244,07-11-2020,0,31858,5,357
245,08-11-2020,0,31858,6,363
246,09-11-2020,2302,34160,7,370
247,10-11-2020,713,34873,6,376
248,11-11-2020,0,34873,7,383
249,12-11-2020,1532,36405,10,393
250,13-11-2020,907,37312,5,398
251,14-11-2020,0,37312,3,401
252,15-11-2020,0,37312,6,407
253,16-11-2020,2877,40189,20,427
254,17-11-2020,773,40962,5,432
255,18-11-2020,730,41692,11,443
256,19-11-2020,1105,42797,8,451
257,20-11-2020,1155,43952,11,462
258,21-11-2020,1336,45288,9,471
259,22-11-2020,1584,46872,0,471
260,23-11-2020,1549,48421,5,476
261,24-11-2020,1115,49536,15,491
262,25-11-2020,1265,50801,9,500
263,26-11-2020,1077,51878,10,510
264,27-11-2020,1227,53105,9,519
265,28-11-2020,1731,54836,5,524
266,29-11-2020,1608,56444,9,533
267,30-11-2020,1733,58177,8,541
268,01-12-2020,1307,59484,10,551
269,02-12-2020,1685,61169,10,561
270,03-12-2020,1854,63023,14,575
271,04-12-2020,1828,64851,15,590
272,05-12-2020,1879,66730,6,596
273,06-12-2020,1836,68566,19,615
274,07-12-2020,1735,70301,16,631
275,08-12-2020,1727,72028,9,640
276,09-12-2020,1460,73488,13,653
277,10-12-2020,1566,75054,13,666
278,11-12-2020,1738,76792,18,684
279,12-12-2020,1590,78382,13,697
280,13-12-2020,1717,80099,22,719
281,14-12-2020,1887,81986,14,733
282,15-12-2020,1341,83327,11,744
283,16-12-2020,1270,84597,16,760
284,17-12-2020,1571,86168,30,790
285,18-12-2020,1413,87581,25,815
286,19-12-2020,1352,88933,26,841
287,20-12-2020,1286,90219,10,851
288,21-12-2020,1240,91459,9,860
289,22-12-2020,1021,92480,11,871
290,23-12-2020,1301,93781,19,890
291,24-12-2020,0,93781,0,890
292,25-12-2020,0,93781,0,890
293,26-12-2020,0,93781,0,890
294,27-12-2020,0,93781,0,890
295,28-12-2020,4488,98269,112,1002
296,29-12-2020,872,99141,26,1028
297,30-12-2020,1287,100428,18,1046
298,31-12-2020,0,100428,0,1046
299,01-01-2021,0,100428,0,1046
300,02-01-2021,0,100428,0,1046
301,03-01-2021,0,100428,0,1046
302,04-01-2021,5107,105535,96,1142
303,05-01-2021,843,106378,26,1168
304,06-01-2021,1123,107501,25,1193
305,07-01-2021,968,108469,24,1217
306,08-01-2021,1183,109652,24,1241
307,09-01-2021,989,110641,31,1272
308,10-01-2021,811,111452,12,1284
309,11-01-2021,639,112091,23,1307
310,12-01-2021,652,112743,38,1345
311,13-01-2021,875,113618,23,1368
312,14-01-2021,967,114585,21,1389
313,15-01-2021,785,115370,13,1402
314,16-01-2021,717,116087,15,1417
315,17-01-2021,750,116837,19,1436
316,18-01-2021,469,117306,11,1447
317,19-01-2021,461,117767,16,1463
318,20-01-2021,669,118436,21,1484
319,21-01-2021,678,119114,16,1500
320,22-01-2021,643,119757,12,1512
321,23-01-2021,573,120330,13,1525
322,24-01-2021,463,120793,24,1549
323,25-01-2021,742,121535,25,1574
324,26-01-2021,366,121901,13,1587
325,27-01-2021,459,122360,12,1599
326,28-01-2021,461,122821,7,1606
327,29-01-2021,543,123364,14,1620
328,30-01-2021,383,123747,11,1631
329,31-01-2021,461,124208,8,1639
330,01-02-2021,355,124563,8,1647
331,02-02-2021,268,124831,13,1660
332,03-02-2021,259,125090,11,1671
333,04-02-2021,582,125672,13,1684
334,05-02-2021,396,126068,9,1693
335,06-02-2021,348,126416,12,1705
336,07-02-2021,351,126767,4,1709
337,08-02-2021,269,127036,1,1710
338,09-02-2021,195,127231,12,1722
339,10-02-2021,339,127570,6,1728
340,11-02-2021,351,127921,16,1744
341,12-02-2021,314,128235,16,1760
342,13-02-2021,305,128540,15,1775
343,14-02-2021,284,128824,5,1780
344,15-02-2021,251,129075,2,1782
345,16-02-2021,263,129338,9,1791
346,17-02-2021,277,129615,7,1798
347,18-02-2021,415,130030,7,1805
348,19-02-2021,325,130355,7,1812
349,20-02-2021,380,130735,6,1818
350,21-02-2021,328,131063,9,1827
351,22-02-2021,273,131336,16,1843
352,23-02-2021,267,131603,10,1853
353,24-02-2021,430,132033,13,1866
354,25-02-2021,399,132432,8,1874
355,26-02-2021,356,132788,3,1877
356,27-02-2021,415,133203,6,1883
357,28-02-2021,301,133504,3,1886
358,01-03-2021,291,133795,2,1888
359,02-03-2021,257,134052,2,1890
360,03-03-2021,402,134454,12,1902
361,04-03-2021,331,134785,9,1911
362,05-03-2021,411,135196,2,1913
363,06-03-2021,341,135537,1,1914
364,07-03-2021,0,135537,0,1914
365,08-03-2021,582,136119,6,1920
366,09-03-2021,255,136374,6,1926
367,10-03-2021,399,136773,2,1928
368,11-03-2021,364,137137,5,1933
369,12-03-2021,427,137564,2,1935
370,13-03-2021,472,138036,5,1940
371,14-03-2021,388,138424,6,1946
372,15-03-2021,364,138788,3,1949
373,16-03-2021,355,139143,3,1952
374,17-03-2021,479,139622,4,1956
375,18-03-2021,505,140127,1,1957
376,19-03-2021,696,140823,0,1957
377,20-03-2021,556,141379,4,1961
378,21-03-2021,555,141934,2,1963
379,22-03-2021,456,142390,5,1968
380,23-03-2021,465,142855,3,1971
381,24-03-2021,692,143547,2,1973
382,25-03-2021,764,144311,3,1976
383,26-03-2021,717,145028,3,1979
384,27-03-2021,668,145696,1,1980
385,28-03-2021,644,146340,3,1983
386,29-03-2021,545,146885,0,1983
387,30-03-2021,576,147461,4,1987
388,31-03-2021,871,148332,3,1990
389,01-04-2021,875,149207,4,1994
390,02-04-2021,0,149207,0,1994
391,03-04-2021,0,149207,0,1994
392,04-04-2021,0,149207,0,1994
393,05-04-2021,3987,153194,4,1998
394,06-04-2021,931,154125,3,2001
395,07-04-2021,1351,155476,1,2002
396,08-04-2021,1429,156905,3,2005
397,09-04-2021,1521,158426,2,2007
398,10-04-2021,1293,159719,5,2012
399,11-04-2021,1183,160902,1,2013
400,12-04-2021,1136,162038,5,2018
401,13-04-2021,1081,163119,3,2021
402,14-04-2021,1412,164531,8,2029
403,15-04-2021,1646,166177,5,2034
404,16-04-2021,1616,167793,0,2034
405,17-04-2021,1486,169279,3,2037
406,18-04-2021,1514,170793,3,2040
407,19-04-2021,1391,172184,3,2043
408,20-04-2021,1347,173531,5,2048
409,21-04-2021,0,173531,0,2048
410,22-04-2021,3556,177087,5,2053
411,23-04-2021,1690,178777,4,2057
412,24-04-2021,1592,180369,0,2057
413,25-04-2021,1437,181806,0,2057
414,26-04-2021,1495,183301,3,2060
415,27-04-2021,1539,184840,7,2067
416,28-04-2021,1839,186679,6,2073
417,29-04-2021,2048,188727,2,2075
418,30-04-2021,2007,190734,7,2082
419,01-05-2021,2433,193167,1,2083
420,02-05-2021,1731,194898,3,2086
421,03-05-2021,2012,196910,4,2090
422,04-05-2021,1743,198653,9,2099
423,05-05-2021,2271,200924,3,2102
424,06-05-2021,2211,203135,0,2102
425,07-05-2021,1980,205115,4,2106
426,08-05-2021,2042,207157,2,2108
427,09-05-2021,1633,208790,2,2110
428,10-05-2021,1597,210387,7,2117
429,11-05-2021,1449,211836,2,2119
430,12-05-2021,1799,213635,4,2123
431,13-05-2021,1558,215193,9,2132
432,14-05-2021,1433,216626,5,2137
433,15-05-2021,1195,217821,3,2140
434,16-05-2021,1140,218961,3,2143
435,17-05-2021,721,219682,5,2148
436,18-05-2021,877,220559,4,2152
437,19-05-2021,908,221467,6,2158
438,20-05-2021,812,222279,4,2162
439,21-05-2021,732,223011,2,2164
440,22-05-2021,621,223632,6,2170
441,23-05-2021,563,224195,6,2176
442,24-05-2021,452,224647,7,2183
443,25-05-2021,387,225034,9,2192
444,26-05-2021,390,225424,6,2198
445,27-05-2021,513,225937,1,2199
446,28-05-2021,512,226449,7,2206
447,29-05-2021,406,226855,8,2214
448,30-05-2021,391,227246,5,2219
449,31-05-2021,263,227509,8,2227
450,01-06-2021,209,227718,1,2228
451,02-06-2021,410,228128,3,2231
452,03-06-2021,296,228424,5,2236
453,04-06-2021,244,228668,7,2243
454,05-06-2021,293,228961,3,2246
455,06-06-2021,231,229192,0,2246
456,07-06-2021,127,229319,2,2248
457,08-06-2021,139,229458,3,2251
458,09-06-2021,313,229771,5,2256
459,10-06-2021,178,229949,6,2262
460,11-06-2021,170,230119,3,2265
461,12-06-2021,179,230298,4,2269
462,13-06-2021,165,230463,1,2270
463,14-06-2021,115,230578,0,2270
464,15-06-2021,127,230705,4,2274
465,16-06-2021,153,230858,4,2278
466,17-06-2021,150,231008,2,2280
467,18-06-2021,124,231132,3,2283
468,19-06-2021,127,231259,6,2289
469,20-06-2021,100,231359,1,2290
470,21-06-2021,60,231419,2,2292
471,22-06-2021,57,231476,-2,2290
472,23-06-2021,92,231568,2,2292
473,24-06-2021,73,231641,1,2293
474,25-06-2021,0,231641,0,2293
475,26-06-2021,0,231641,0,2293
476,27-06-2021,0,231641,0,2293
477,28-06-2021,209,231850,2,2295
478,29-06-2021,61,231911,4,2299
479,30-06-2021,76,231987,2,2301
480,01-07-2021,0,231987,0,2301
481,02-07-2021,110,232097,0,2301
482,03-07-2021,0,232097,0,2301
483,04-07-2021,0,232097,0,2301
484,05-07-2021,139,232236,2,2303
485,06-07-2021,33,232269,2,2305
486,07-07-2021,67,232336,2,2307
487,08-07-2021,23,232359,0,2307
488,09-07-2021,52,232411,0,2307
489,10-07-2021,0,232411,0,2307
490,11-07-2021,0,232411,0,2307
491,12-07-2021,90,232501,0,2307
492,13-07-2021,35,232536,3,2310
493,14-07-2021,46,232582,1,2311
494,15-07-2021,53,232635,1,2312
495,16-07-2021,41,232676,2,2314
496,17-07-2021,0,232676,0,2314
497,18-07-2021,0,232676,0,2314
498,19-07-2021,130,232806,2,2316
499,20-07-2021,69,232875,2,2318
500,21-07-2021,81,232956,0,2318
501,22-07-2021,106,233062,2,2320
502,23-07-2021,98,233160,2,2322
503,24-07-2021,0,233160,0,2322
504,25-07-2021,0,233160,0,2322
505,26-07-2021,387,233547,0,2322
506,27-07-2021,134,233681,3,2325
507,28-07-2021,194,233875,0,2325
508,29-07-2021,233,234108,0,2325
509,30-07-2021,187,234295,3,2328
510,31-07-2021,0,234295,0,2328
511,01-08-2021,0,234295,0,2328
512,02-08-2021,0,234295,0,2328
513,03-08-2021,743,235038,0,2328
514,04-08-2021,206,235244,0,2328
515,05-08-2021,397,235641,1,2329
516,06-08-2021,369,236010,-4,2325
517,07-08-2021,0,236010,0,2325
518,08-08-2021,0,236010,0,2325
519,09-08-2021,1017,237027,3,2328
520,10-08-2021,279,237306,2,2330
521,11-08-2021,501,237807,1,2331
522,12-08-2021,550,238357,0,2331
523,13-08-2021,582,238939,1,2332
524,14-08-2021,0,238939,0,2332
525,15-08-2021,0,238939,0,2332
526,16-08-2021,1407,240346,1,2333
527,17-08-2021,407,240753,3,2336
528,18-08-2021,678,241431,2,2338
529,19-08-2021,817,242248,4,2342
530,20-08-2021,749,242997,1,2343
531,21-08-2021,0,242997,0,2343
532,22-08-2021,0,242997,0,2343
533,23-08-2021,1972,244969,5,2348
534,24-08-2021,629,245598,7,2355
535,25-08-2021,1076,246674,1,2356
536,26-08-2021,1112,247786,4,2360
537,27-08-2021,1168,248954,4,2364
538,28-08-2021,0,248954,0,2364
539,29-08-2021,0,248954,0,2364
540,30-08-2021,3056,252010,7,2371
541,31-08-2021,920,252930,4,2375
542,01-09-2021,1315,254245,8,2383
543,02-09-2021,1339,255584,5,2388
544,03-09-2021,1401,256985,2,2390
545,04-09-2021,0,256985,0,2390
546,05-09-2021,0,256985,0,2390
547,06-09-2021,0,256985,0,2390
548,07-09-2021,4903,261888,17,2407
549,08-09-2021,1166,263054,18,2425
550,09-09-2021,1510,264564,9,2434
551,10-09-2021,1473,266037,10,2444
552,11-09-2021,0,266037,0,2444
553,12-09-2021,0,266037,0,2444
554,13-09-2021,4740,270777,18,2462
555,14-09-2021,1434,272211,9,2471
556,15-09-2021,1609,273820,24,2495
557,16-09-2021,1718,275538,10,2505
558,17-09-2021,2020,277558,18,2523
559,18-09-2021,0,277558,0,2523
560,19-09-2021,0,277558,0,2523
561,20-09-2021,4633,282191,22,2545
562,21-09-2021,1519,283710,29,2574
563,22-09-2021,1336,285046,20,2594
564,23-09-2021,1660,286706,17,2611
565,24-09-2021,1651,288357,11,2622
566,25-09-2021,0,288357,0,2622
567,26-09-2021,0,288357,0,2622
568,27-09-2021,5181,293538,23,2645
569,28-09-2021,1246,294784,18,2663
570,29-09-2021,1682,296466,34,2697
571,30-09-2021,1706,298172,20,2717
572,01-10-2021,1630,299802,14,2731
573,02-10-2021,0,299802,0,2731
574,03-10-2021,0,299802,0,2731
575,04-10-2021,4037,303839,21,2752
576,05-10-2021,663,304502,26,2778
577,06-10-2021,1263,305765,26,2804
578,07-10-2021,1254,307019,10,2814
579,08-10-2021,1256,308275,16,2830
580,09-10-2021,0,308275,0,2830
581,10-10-2021,0,308275,0,2830
582,11-10-2021,0,308275,0,2830
583,12-10-2021,3358,311633,33,2863
584,13-10-2021,652,312285,38,2901
585,14-10-2021,916,313201,29,2930
586,15-10-2021,1051,314252,16,2946
587,16-10-2021,0,314252,0,2946
588,17-10-2021,0,314252,0,2946
589,18-10-2021,2181,316433,30,2976
590,19-10-2021,531,316964,12,2988
591,20-10-2021,786,317750,18,3006
592,21-10-2021,770,318520,8,3014
593,22-10-2021,656,319176,12,3026
594,23-10-2021,0,319176,0,3026
595,24-10-2021,0,319176,0,3026
596,25-10-2021,1592,320768,25,3051
597,26-10-2021,442,321210,12,3063
598,27-10-2021,645,321855,10,3073
599,28-10-2021,531,322386,12,3085
600,29-10-2021,603,322989,8,3093
601,30-10-2021,0,322989,0,3093
602,31-10-2021,0,322989,0,3093
603,01-11-2021,1159,324148,18,3111
604,02-11-2021,366,324514,8,3119
605,03-11-2021,487,325001,14,3133
606,04-11-2021,516,325517,4,3137
607,05-11-2021,466,325983,5,3142
608,06-11-2021,0,325983,0,3142
609,07-11-2021,0,325983,0,3142
610,08-11-2021,1300,327283,13,3155
611,09-11-2021,422,327705,4,3159
612,10-11-2021,484,328189,5,3164
613,11-11-2021,0,328189,0,3164
614,12-11-2021,841,329030,7,3171
615,13-11-2021,0,329030,0,3171
616,14-11-2021,0,329030,0,3171
617,15-11-2021,1068,330098,17,3188
618,16-11-2021,321,330419,13,3201
619,17-11-2021,412,330831,3,3204
620,18-11-2021,383,331214,5,3209
621,19-11-2021,412,331626,1,3210
622,20-11-2021,0,331626,0,3210
623,21-11-2021,0,331626,0,3210
624,22-11-2021,1124,332750,6,3216
625,23-11-2021,252,333002,9,3225
626,24-11-2021,464,333466,4,3229
627,25-11-2021,379,333845,1,3230
628,26-11-2021,356,334201,3,3233
629,27-11-2021,0,334201,0,3233
630,28-11-2021,0,334201,0,3233
631,29-11-2021,806,335007,7,3240
632,30-11-2021,240,335247,6,3246
633,01-12-2021,430,335677,7,3253
634,02-12-2021,366,336043,2,3255
635,03-12-2021,349,336392,1,3256
636,04-12-2021,0,336392,0,3256
637,05-12-2021,0,336392,0,3256
638,06-12-2021,788,337180,5,3261
639,07-12-2021,240,337420,7,3268
640,08-12-2021,388,337808,4,3272
641,09-12-2021,333,338141,-1,3271
642,10-12-2021,287,338428,1,3272
643,11-12-2021,0,338428,0,3272
644,12-12-2021,0,338428,0,3272
645,13-12-2021,863,339291,3,3275
646,14-12-2021,250,339541,8,3283
647,15-12-2021,456,339997,3,3286
648,16-12-2021,473,340470,-1,3285
649,17-12-2021,553,341023,1,3286
650,18-12-2021,0,341023,0,3286
651,19-12-2021,0,341023,0,3286
652,20-12-2021,1925,342948,6,3292
653,21-12-2021,786,343734,2,3294
654,22-12-2021,1346,345080,5,3299
655,23-12-2021,1625,346705,0,3299
656,24-12-2021,1888,348593,0,3299
657,25-12-2021,2509,351102,0,3299
658,26-12-2021,1592,352694,0,3299
659,27-12-2021,710,353404,0,3299
660,28-12-2021,1419,354823,0,3299
661,29-12-2021,2800,357623,11,3310
662,30-12-2021,4356,361979,0,3310
663,31-12-2021,4578,366557,0,3310
664,01-01-2022,4533,371090,0,3310
665,02-01-2022,3286,374376,0,3310
666,03-01-2022,2022,376398,0,3310
667,04-01-2022,2976,379374,12,3322
668,05-01-2022,4752,384126,11,3333
