,reporting_date,daily_cases,cumulative_cases,daily_deaths,cumulative_deaths
0,08-03-2020,0,0,0,0
1,09-03-2020,0,0,0,0
2,10-03-2020,0,0,0,0
3,11-03-2020,0,0,0,0
4,12-03-2020,0,0,0,0
5,13-03-2020,0,0,0,0
6,14-03-2020,1,1,0,0
7,15-03-2020,0,1,0,0
8,16-03-2020,0,1,0,0
9,17-03-2020,2,3,0,0
10,18-03-2020,0,3,0,0
11,19-03-2020,0,3,0,0
12,20-03-2020,1,4,0,0
13,21-03-2020,2,6,0,0
14,22-03-2020,3,9,0,0
15,23-03-2020,15,24,0,0
16,24-03-2020,11,35,0,0
17,25-03-2020,32,67,0,0
18,26-03-2020,15,82,0,0
19,27-03-2020,20,102,0,0
20,28-03-2020,18,120,0,0
21,29-03-2020,15,135,0,0
22,30-03-2020,13,148,1,1
23,31-03-2020,4,152,0,1
24,01-04-2020,23,175,0,1
25,02-04-2020,8,183,0,1
26,03-04-2020,12,195,0,1
27,04-04-2020,8,203,0,1
28,05-04-2020,14,217,0,1
29,06-04-2020,9,226,1,2
30,07-04-2020,2,228,0,2
31,08-04-2020,4,232,0,2
32,09-04-2020,4,236,0,2
33,10-04-2020,3,239,1,3
34,11-04-2020,2,241,0,3
35,12-04-2020,1,242,0,3
36,13-04-2020,2,244,0,3
37,14-04-2020,0,244,0,3
38,15-04-2020,3,247,0,3
39,16-04-2020,5,252,0,3
40,17-04-2020,4,256,0,3
41,18-04-2020,0,256,0,3
42,19-04-2020,0,256,0,3
43,20-04-2020,0,256,0,3
44,21-04-2020,0,256,0,3
45,22-04-2020,0,256,0,3
46,23-04-2020,0,256,0,3
47,24-04-2020,0,256,0,3
48,25-04-2020,1,257,0,3
49,26-04-2020,1,258,0,3
50,27-04-2020,0,258,0,3
51,28-04-2020,0,258,0,3
52,29-04-2020,0,258,0,3
53,30-04-2020,0,258,0,3
54,01-05-2020,1,259,0,3
55,02-05-2020,0,259,0,3
56,03-05-2020,0,259,0,3
57,04-05-2020,0,259,0,3
58,05-05-2020,0,259,0,3
59,06-05-2020,0,259,0,3
60,07-05-2020,1,260,0,3
61,08-05-2020,0,260,0,3
62,09-05-2020,0,260,0,3
63,10-05-2020,0,260,0,3
64,11-05-2020,0,260,0,3
65,12-05-2020,0,260,0,3
66,13-05-2020,0,260,0,3
67,14-05-2020,0,260,0,3
68,15-05-2020,0,260,0,3
69,16-05-2020,0,260,0,3
70,17-05-2020,0,260,0,3
71,18-05-2020,0,260,0,3
72,19-05-2020,0,260,0,3
73,20-05-2020,0,260,0,3
74,21-05-2020,0,260,0,3
75,22-05-2020,0,260,0,3
76,23-05-2020,0,260,0,3
77,24-05-2020,0,260,0,3
78,25-05-2020,0,260,0,3
79,26-05-2020,0,260,0,3
80,27-05-2020,0,260,0,3
81,28-05-2020,1,261,0,3
82,29-05-2020,0,261,0,3
83,30-05-2020,0,261,0,3
84,31-05-2020,0,261,0,3
85,01-06-2020,0,261,0,3
86,02-06-2020,0,261,0,3
87,03-06-2020,0,261,0,3
88,04-06-2020,0,261,0,3
89,05-06-2020,0,261,0,3
90,06-06-2020,0,261,0,3
91,07-06-2020,0,261,0,3
92,08-06-2020,0,261,0,3
93,09-06-2020,0,261,0,3
94,10-06-2020,0,261,0,3
95,11-06-2020,0,261,0,3
96,12-06-2020,0,261,0,3
97,13-06-2020,0,261,0,3
98,14-06-2020,0,261,0,3
99,15-06-2020,0,261,0,3
100,16-06-2020,0,261,0,3
101,17-06-2020,0,261,0,3
102,18-06-2020,0,261,0,3
103,19-06-2020,0,261,0,3
104,20-06-2020,0,261,0,3
105,21-06-2020,0,261,0,3
106,22-06-2020,0,261,0,3
107,23-06-2020,0,261,0,3
108,24-06-2020,0,261,0,3
109,25-06-2020,0,261,0,3
110,26-06-2020,0,261,0,3
111,27-06-2020,0,261,0,3
112,28-06-2020,0,261,0,3
113,29-06-2020,0,261,0,3
114,30-06-2020,0,261,0,3
115,01-07-2020,0,261,0,3
116,02-07-2020,0,261,0,3
117,03-07-2020,0,261,0,3
118,04-07-2020,0,261,0,3
119,05-07-2020,0,261,0,3
120,06-07-2020,0,261,0,3
121,07-07-2020,0,261,0,3
122,08-07-2020,0,261,0,3
123,09-07-2020,0,261,0,3
124,10-07-2020,1,262,0,3
125,11-07-2020,0,262,0,3
126,12-07-2020,0,262,0,3
127,13-07-2020,0,262,0,3
128,14-07-2020,0,262,0,3
129,15-07-2020,0,262,0,3
130,16-07-2020,0,262,0,3
131,17-07-2020,0,262,0,3
132,18-07-2020,0,262,0,3
133,19-07-2020,0,262,0,3
134,20-07-2020,0,262,0,3
135,21-07-2020,1,263,0,3
136,22-07-2020,1,264,0,3
137,23-07-2020,0,264,0,3
138,24-07-2020,1,265,0,3
139,25-07-2020,0,265,0,3
140,26-07-2020,1,266,0,3
141,27-07-2020,0,266,0,3
142,28-07-2020,0,266,0,3
143,29-07-2020,0,266,0,3
144,30-07-2020,0,266,0,3
145,31-07-2020,0,266,0,3
146,01-08-2020,0,266,0,3
147,02-08-2020,0,266,0,3
148,03-08-2020,0,266,0,3
149,04-08-2020,0,266,0,3
150,05-08-2020,0,266,0,3
151,06-08-2020,0,266,0,3
152,07-08-2020,1,267,0,3
153,08-08-2020,0,267,0,3
154,09-08-2020,0,267,0,3
155,10-08-2020,1,268,0,3
156,11-08-2020,0,268,0,3
157,12-08-2020,0,268,0,3
158,13-08-2020,0,268,0,3
159,14-08-2020,0,268,0,3
160,15-08-2020,0,268,0,3
161,16-08-2020,0,268,0,3
162,17-08-2020,0,268,0,3
163,18-08-2020,0,268,0,3
164,19-08-2020,0,268,0,3
165,20-08-2020,0,268,0,3
166,21-08-2020,0,268,0,3
167,22-08-2020,0,268,0,3
168,23-08-2020,0,268,0,3
169,24-08-2020,0,268,0,3
170,25-08-2020,0,268,0,3
171,26-08-2020,0,268,0,3
172,27-08-2020,0,268,0,3
173,28-08-2020,1,269,0,3
174,29-08-2020,0,269,0,3
175,30-08-2020,0,269,0,3
176,31-08-2020,0,269,0,3
177,01-09-2020,0,269,0,3
178,02-09-2020,0,269,0,3
179,03-09-2020,0,269,0,3
180,04-09-2020,0,269,0,3
181,05-09-2020,1,270,0,3
182,06-09-2020,0,270,0,3
183,07-09-2020,0,270,0,3
184,08-09-2020,0,270,0,3
185,09-09-2020,0,270,0,3
186,10-09-2020,0,270,0,3
187,11-09-2020,0,270,0,3
188,12-09-2020,1,271,0,3
189,13-09-2020,0,271,0,3
190,14-09-2020,0,271,0,3
191,15-09-2020,0,271,0,3
192,16-09-2020,0,271,0,3
193,17-09-2020,0,271,0,3
194,18-09-2020,1,272,0,3
195,19-09-2020,0,272,0,3
196,20-09-2020,0,272,0,3
197,21-09-2020,0,272,0,3
198,22-09-2020,0,272,0,3
199,23-09-2020,0,272,0,3
200,24-09-2020,0,272,0,3
201,25-09-2020,0,272,0,3
202,26-09-2020,0,272,0,3
203,27-09-2020,1,273,0,3
204,28-09-2020,0,273,0,3
205,29-09-2020,0,273,0,3
206,30-09-2020,1,274,0,3
207,01-10-2020,1,275,0,3
208,02-10-2020,0,275,0,3
209,03-10-2020,1,276,1,4
210,04-10-2020,1,277,0,4
211,05-10-2020,0,277,0,4
212,06-10-2020,0,277,0,4
213,07-10-2020,0,277,0,4
214,08-10-2020,0,277,0,4
215,09-10-2020,2,279,0,4
216,10-10-2020,3,282,0,4
217,11-10-2020,0,282,0,4
218,12-10-2020,1,283,0,4
219,13-10-2020,0,283,0,4
220,14-10-2020,0,283,0,4
221,15-10-2020,1,284,0,4
222,16-10-2020,3,287,0,4
223,17-10-2020,0,287,0,4
224,18-10-2020,0,287,0,4
225,19-10-2020,0,287,0,4
226,20-10-2020,0,287,0,4
227,21-10-2020,0,287,0,4
228,22-10-2020,1,288,0,4
229,23-10-2020,0,288,0,4
230,24-10-2020,1,289,0,4
231,25-10-2020,1,290,0,4
232,26-10-2020,1,291,0,4
233,27-10-2020,0,291,0,4
234,28-10-2020,0,291,0,4
235,29-10-2020,0,291,0,4
236,30-10-2020,0,291,0,4
237,31-10-2020,0,291,0,4
238,01-11-2020,0,291,0,4
239,02-11-2020,0,291,0,4
240,03-11-2020,0,291,0,4
241,04-11-2020,1,292,0,4
242,05-11-2020,2,294,0,4
243,06-11-2020,0,294,0,4
244,07-11-2020,2,296,0,4
245,08-11-2020,0,296,0,4
246,09-11-2020,0,296,0,4
247,10-11-2020,0,296,0,4
248,11-11-2020,2,298,0,4
249,12-11-2020,0,298,0,4
250,13-11-2020,1,299,0,4
251,14-11-2020,2,301,0,4
252,15-11-2020,2,303,0,4
253,16-11-2020,0,303,0,4
254,17-11-2020,2,305,0,4
255,18-11-2020,2,307,0,4
256,19-11-2020,1,308,0,4
257,20-11-2020,3,311,0,4
258,21-11-2020,5,316,0,4
259,22-11-2020,3,319,0,4
260,23-11-2020,2,321,0,4
261,24-11-2020,2,323,0,4
262,25-11-2020,1,324,0,4
263,26-11-2020,3,327,0,4
264,27-11-2020,4,331,0,4
265,28-11-2020,2,333,0,4
266,29-11-2020,4,337,0,4
267,30-11-2020,1,338,0,4
268,01-12-2020,1,339,0,4
269,02-12-2020,1,340,0,4
270,03-12-2020,0,340,0,4
271,04-12-2020,3,343,0,4
272,05-12-2020,4,347,0,4
273,06-12-2020,4,351,0,4
274,07-12-2020,0,351,0,4
275,08-12-2020,1,352,0,4
276,09-12-2020,1,353,0,4
277,10-12-2020,1,354,0,4
278,11-12-2020,1,355,0,4
279,12-12-2020,2,357,0,4
280,13-12-2020,0,357,0,4
281,14-12-2020,1,358,0,4
282,15-12-2020,1,359,0,4
283,16-12-2020,5,364,0,4
284,17-12-2020,3,367,0,4
285,18-12-2020,5,372,0,4
286,19-12-2020,8,380,0,4
287,20-12-2020,2,382,0,4
288,21-12-2020,0,382,0,4
289,22-12-2020,1,383,0,4
290,23-12-2020,1,384,0,4
291,24-12-2020,0,384,0,4
292,25-12-2020,0,384,0,4
293,26-12-2020,0,384,0,4
294,27-12-2020,3,387,0,4
295,28-12-2020,2,389,0,4
296,29-12-2020,1,390,0,4
297,30-12-2020,0,390,0,4
298,31-12-2020,0,390,0,4
299,01-01-2021,0,390,0,4
300,02-01-2021,0,390,0,4
301,03-01-2021,0,390,0,4
302,04-01-2021,1,391,0,4
303,05-01-2021,1,392,0,4
304,06-01-2021,0,392,0,4
305,07-01-2021,0,392,0,4
306,08-01-2021,0,392,0,4
307,09-01-2021,0,392,0,4
308,10-01-2021,1,393,0,4
309,11-01-2021,0,393,0,4
310,12-01-2021,0,393,0,4
311,13-01-2021,0,393,0,4
312,14-01-2021,1,394,0,4
313,15-01-2021,1,395,0,4
314,16-01-2021,0,395,0,4
315,17-01-2021,1,396,0,4
316,18-01-2021,0,396,0,4
317,19-01-2021,0,396,0,4
318,20-01-2021,0,396,0,4
319,21-01-2021,1,397,0,4
320,22-01-2021,1,398,0,4
321,23-01-2021,0,398,0,4
322,24-01-2021,0,398,0,4
323,25-01-2021,0,398,0,4
324,26-01-2021,0,398,0,4
325,27-01-2021,2,400,0,4
326,28-01-2021,4,404,0,4
327,29-01-2021,4,408,0,4
328,30-01-2021,0,408,0,4
329,31-01-2021,0,408,0,4
330,01-02-2021,0,408,0,4
331,02-02-2021,0,408,0,4
332,03-02-2021,2,410,0,4
333,04-02-2021,1,411,0,4
334,05-02-2021,1,412,0,4
335,06-02-2021,3,415,0,4
336,07-02-2021,1,416,0,4
337,08-02-2021,11,427,0,4
338,09-02-2021,30,457,0,4
339,10-02-2021,53,510,0,4
340,11-02-2021,100,610,0,4
341,12-02-2021,50,660,0,4
342,13-02-2021,26,686,0,4
343,14-02-2021,11,697,0,4
344,15-02-2021,7,704,0,4
345,16-02-2021,7,711,0,4
346,17-02-2021,44,755,0,4
347,18-02-2021,48,803,0,4
348,19-02-2021,60,863,0,4
349,20-02-2021,38,901,0,4
350,21-02-2021,25,926,0,4
351,22-02-2021,13,939,0,4
352,23-02-2021,15,954,0,4
353,24-02-2021,8,962,1,5
354,25-02-2021,10,972,0,5
355,26-02-2021,4,976,0,5
356,27-02-2021,4,980,1,6
357,28-02-2021,7,987,0,6
358,01-03-2021,2,989,0,6
359,02-03-2021,5,994,0,6
360,03-03-2021,3,997,0,6
361,04-03-2021,5,1002,0,6
362,05-03-2021,1,1003,0,6
363,06-03-2021,2,1005,0,6
364,07-03-2021,1,1006,0,6
365,08-03-2021,3,1009,0,6
366,09-03-2021,1,1010,0,6
367,10-03-2021,0,1010,0,6
368,11-03-2021,1,1011,0,6
369,12-03-2021,1,1012,0,6
370,13-03-2021,0,1012,0,6
371,14-03-2021,0,1012,0,6
372,15-03-2021,0,1012,0,6
373,16-03-2021,1,1013,0,6
374,17-03-2021,0,1013,0,6
375,18-03-2021,1,1014,0,6
376,19-03-2021,0,1014,0,6
377,20-03-2021,0,1014,0,6
378,21-03-2021,0,1014,0,6
379,22-03-2021,0,1014,0,6
380,23-03-2021,0,1014,0,6
381,24-03-2021,1,1015,0,6
382,25-03-2021,0,1015,0,6
383,26-03-2021,0,1015,0,6
384,27-03-2021,0,1015,0,6
385,28-03-2021,1,1016,0,6
386,29-03-2021,0,1016,0,6
387,30-03-2021,2,1018,0,6
388,31-03-2021,1,1019,0,6
389,01-04-2021,1,1020,0,6
390,02-04-2021,0,1020,0,6
391,03-04-2021,0,1020,0,6
392,04-04-2021,0,1020,0,6
393,05-04-2021,0,1020,0,6
394,06-04-2021,0,1020,0,6
395,07-04-2021,1,1021,0,6
396,08-04-2021,1,1022,0,6
397,09-04-2021,3,1025,0,6
398,10-04-2021,4,1029,0,6
399,11-04-2021,1,1030,0,6
400,12-04-2021,0,1030,0,6
401,13-04-2021,1,1031,0,6
402,14-04-2021,3,1034,0,6
403,15-04-2021,2,1036,0,6
404,16-04-2021,3,1039,0,6
405,17-04-2021,3,1042,0,6
406,18-04-2021,1,1043,0,6
407,19-04-2021,3,1046,0,6
408,20-04-2021,2,1048,0,6
409,21-04-2021,1,1049,0,6
410,22-04-2021,3,1052,0,6
411,23-04-2021,1,1053,0,6
412,24-04-2021,3,1056,0,6
413,25-04-2021,2,1058,0,6
414,26-04-2021,4,1062,0,6
415,27-04-2021,0,1062,0,6
416,28-04-2021,4,1066,0,6
417,29-04-2021,2,1068,0,6
418,30-04-2021,8,1076,0,6
419,01-05-2021,5,1081,0,6
420,02-05-2021,18,1099,0,6
421,03-05-2021,5,1104,0,6
422,04-05-2021,4,1108,0,6
423,05-05-2021,6,1114,0,6
424,06-05-2021,6,1120,0,6
425,07-05-2021,7,1127,0,6
426,08-05-2021,6,1133,0,6
427,09-05-2021,5,1138,0,6
428,10-05-2021,3,1141,0,6
429,11-05-2021,15,1156,0,6
430,12-05-2021,10,1166,0,6
431,13-05-2021,7,1173,0,6
432,14-05-2021,6,1179,0,6
433,15-05-2021,5,1184,0,6
434,16-05-2021,9,1193,0,6
435,17-05-2021,10,1203,0,6
436,18-05-2021,6,1209,0,6
437,19-05-2021,3,1212,0,6
438,20-05-2021,4,1216,0,6
439,21-05-2021,10,1226,0,6
440,22-05-2021,4,1230,0,6
441,23-05-2021,23,1253,0,6
442,24-05-2021,5,1258,0,6
443,25-05-2021,11,1269,0,6
444,26-05-2021,4,1273,0,6
445,27-05-2021,6,1279,0,6
446,28-05-2021,14,1293,0,6
447,29-05-2021,9,1302,0,6
448,30-05-2021,7,1309,0,6
449,31-05-2021,2,1311,0,6
450,01-06-2021,6,1317,0,6
451,02-06-2021,17,1334,0,6
452,03-06-2021,6,1340,0,6
453,04-06-2021,2,1342,0,6
454,05-06-2021,5,1347,0,6
455,06-06-2021,5,1352,0,6
456,07-06-2021,2,1354,0,6
457,08-06-2021,3,1357,1,7
458,09-06-2021,3,1360,0,7
459,10-06-2021,5,1365,0,7
460,11-06-2021,3,1368,0,7
461,12-06-2021,6,1374,0,7
462,13-06-2021,1,1375,0,7
463,14-06-2021,4,1379,0,7
464,15-06-2021,2,1381,0,7
465,16-06-2021,1,1382,0,7
466,17-06-2021,1,1383,0,7
467,18-06-2021,0,1383,0,7
468,19-06-2021,0,1383,0,7
469,20-06-2021,0,1383,0,7
470,21-06-2021,0,1383,0,7
471,22-06-2021,1,1384,0,7
472,23-06-2021,0,1384,0,7
473,24-06-2021,0,1384,0,7
474,25-06-2021,0,1384,0,7
475,26-06-2021,0,1384,0,7
476,27-06-2021,0,1384,0,7
477,28-06-2021,1,1385,0,7
478,29-06-2021,0,1385,0,7
479,30-06-2021,1,1386,0,7
480,01-07-2021,0,1386,0,7
481,02-07-2021,1,1387,0,7
482,03-07-2021,0,1387,0,7
483,04-07-2021,0,1387,0,7
484,05-07-2021,13,1400,0,7
485,06-07-2021,0,1400,0,7
486,07-07-2021,0,1400,0,7
487,08-07-2021,0,1400,0,7
488,09-07-2021,2,1402,0,7
489,10-07-2021,0,1402,0,7
490,11-07-2021,0,1402,0,7
491,12-07-2021,0,1402,0,7
492,13-07-2021,5,1407,0,7
493,14-07-2021,3,1410,0,7
494,15-07-2021,23,1433,0,7
495,16-07-2021,0,1433,0,7
496,17-07-2021,0,1433,0,7
497,18-07-2021,0,1433,0,7
498,19-07-2021,4,1437,0,7
499,20-07-2021,0,1437,0,7
500,21-07-2021,0,1437,0,7
501,22-07-2021,0,1437,0,7
502,23-07-2021,0,1437,0,7
503,24-07-2021,0,1437,0,7
504,25-07-2021,0,1437,0,7
505,26-07-2021,0,1437,0,7
506,27-07-2021,0,1437,0,7
507,28-07-2021,0,1437,0,7
508,29-07-2021,0,1437,0,7
509,30-07-2021,0,1437,0,7
510,31-07-2021,0,1437,0,7
511,01-08-2021,0,1437,0,7
512,02-08-2021,3,1440,0,7
513,03-08-2021,0,1440,0,7
514,04-08-2021,1,1441,0,7
515,05-08-2021,0,1441,0,7
516,06-08-2021,2,1443,0,7
517,07-08-2021,0,1443,0,7
518,08-08-2021,0,1443,0,7
519,09-08-2021,0,1443,0,7
520,10-08-2021,0,1443,0,7
521,11-08-2021,0,1443,0,7
522,12-08-2021,0,1443,0,7
523,13-08-2021,4,1447,0,7
524,14-08-2021,0,1447,0,7
525,15-08-2021,0,1447,0,7
526,16-08-2021,3,1450,0,7
527,17-08-2021,0,1450,0,7
528,18-08-2021,6,1456,0,7
529,19-08-2021,0,1456,0,7
530,20-08-2021,2,1458,0,7
531,21-08-2021,0,1458,0,7
532,22-08-2021,0,1458,0,7
533,23-08-2021,2,1460,1,8
534,24-08-2021,0,1460,0,8
535,25-08-2021,2,1462,-1,7
536,26-08-2021,0,1462,0,7
537,27-08-2021,7,1469,0,7
538,28-08-2021,0,1469,0,7
539,29-08-2021,0,1469,0,7
540,30-08-2021,9,1478,0,7
541,31-08-2021,0,1478,0,7
542,01-09-2021,8,1486,0,7
543,02-09-2021,0,1486,0,7
544,03-09-2021,5,1491,0,7
545,04-09-2021,0,1491,0,7
546,05-09-2021,0,1491,0,7
547,06-09-2021,15,1506,0,7
548,07-09-2021,5,1511,0,7
549,08-09-2021,9,1520,0,7
550,09-09-2021,0,1520,0,7
551,10-09-2021,12,1532,0,7
552,11-09-2021,0,1532,0,7
553,12-09-2021,0,1532,0,7
554,13-09-2021,9,1541,0,7
555,14-09-2021,0,1541,0,7
556,15-09-2021,10,1551,0,7
557,16-09-2021,0,1551,0,7
558,17-09-2021,4,1555,0,7
559,18-09-2021,0,1555,0,7
560,19-09-2021,0,1555,0,7
561,20-09-2021,15,1570,0,7
562,21-09-2021,16,1586,0,7
563,22-09-2021,23,1609,0,7
564,23-09-2021,0,1609,0,7
565,24-09-2021,45,1654,0,7
566,25-09-2021,14,1668,0,7
567,26-09-2021,24,1692,0,7
568,27-09-2021,25,1717,1,8
569,28-09-2021,14,1731,0,8
570,29-09-2021,16,1747,0,8
571,30-09-2021,0,1747,0,8
572,01-10-2021,41,1788,2,10
573,02-10-2021,8,1796,0,10
574,03-10-2021,8,1804,0,10
575,04-10-2021,15,1819,0,10
576,05-10-2021,5,1824,0,10
577,06-10-2021,9,1833,0,10
578,07-10-2021,7,1840,0,10
579,08-10-2021,8,1848,1,11
580,09-10-2021,0,1848,0,11
581,10-10-2021,0,1848,0,11
582,11-10-2021,0,1848,0,11
583,12-10-2021,21,1869,2,13
584,13-10-2021,4,1873,0,13
585,14-10-2021,4,1877,0,13
586,15-10-2021,4,1881,0,13
587,16-10-2021,0,1881,0,13
588,17-10-2021,0,1881,0,13
589,18-10-2021,8,1889,2,15
590,19-10-2021,0,1889,0,15
591,20-10-2021,9,1898,0,15
592,21-10-2021,0,1898,0,15
593,22-10-2021,30,1928,0,15
594,23-10-2021,0,1928,0,15
595,24-10-2021,0,1928,0,15
596,25-10-2021,36,1964,0,15
597,26-10-2021,0,1964,0,15
598,27-10-2021,20,1984,1,16
599,28-10-2021,0,1984,0,16
600,29-10-2021,8,1992,0,16
601,30-10-2021,0,1992,0,16
602,31-10-2021,0,1992,0,16
603,01-11-2021,2,1994,0,16
604,02-11-2021,0,1994,0,16
605,03-11-2021,1,1995,0,16
606,04-11-2021,0,1995,0,16
607,05-11-2021,8,2003,0,16
608,06-11-2021,0,2003,0,16
609,07-11-2021,0,2003,0,16
610,08-11-2021,9,2012,0,16
611,09-11-2021,0,2012,0,16
612,10-11-2021,7,2019,0,16
613,11-11-2021,0,2019,0,16
614,12-11-2021,6,2025,0,16
615,13-11-2021,0,2025,0,16
616,14-11-2021,0,2025,0,16
617,15-11-2021,2,2027,1,17
618,16-11-2021,0,2027,0,17
619,17-11-2021,4,2031,0,17
620,18-11-2021,0,2031,0,17
621,19-11-2021,4,2035,0,17
622,20-11-2021,0,2035,0,17
623,21-11-2021,0,2035,0,17
624,22-11-2021,3,2038,0,17
625,23-11-2021,0,2038,0,17
626,24-11-2021,4,2042,1,18
627,25-11-2021,0,2042,0,18
628,26-11-2021,6,2048,0,18
629,27-11-2021,0,2048,0,18
630,28-11-2021,0,2048,0,18
631,29-11-2021,9,2057,0,18
632,30-11-2021,0,2057,0,18
633,01-12-2021,2,2059,0,18
634,02-12-2021,0,2059,0,18
635,03-12-2021,5,2064,0,18
636,04-12-2021,0,2064,0,18
637,05-12-2021,0,2064,0,18
638,06-12-2021,0,2064,0,18
639,07-12-2021,7,2071,0,18
640,08-12-2021,5,2076,0,18
641,09-12-2021,0,2076,0,18
642,10-12-2021,2,2078,0,18
643,11-12-2021,0,2078,0,18
644,12-12-2021,0,2078,0,18
645,13-12-2021,15,2093,0,18
646,14-12-2021,0,2093,0,18
647,15-12-2021,13,2106,0,18
648,16-12-2021,0,2106,0,18
649,17-12-2021,46,2152,0,18
650,18-12-2021,0,2152,0,18
651,19-12-2021,61,2213,0,18
652,20-12-2021,27,2240,0,18
653,21-12-2021,27,2267,0,18
654,22-12-2021,60,2327,0,18
655,23-12-2021,100,2427,0,18
656,24-12-2021,85,2512,0,18
657,25-12-2021,0,2512,0,18
658,26-12-2021,0,2512,0,18
659,27-12-2021,0,2512,0,18
660,28-12-2021,0,2512,0,18
661,29-12-2021,861,3373,0,18
662,30-12-2021,340,3713,0,18
663,31-12-2021,436,4149,1,19
664,01-01-2022,0,4149,0,19
665,02-01-2022,0,4149,0,19
666,03-01-2022,1403,5552,1,20
667,04-01-2022,488,6040,0,20
668,05-01-2022,491,6531,0,20
