,reporting_date,daily_cases,cumulative_cases,daily_deaths,cumulative_deaths
0,12-03-2020,1,1,0,0
1,13-03-2020,3,4,0,0
2,14-03-2020,0,4,0,0
3,15-03-2020,3,7,0,0
4,16-03-2020,1,8,0,0
5,17-03-2020,7,15,0,0
6,18-03-2020,2,17,0,0
7,19-03-2020,0,17,0,0
8,20-03-2020,0,17,0,0
9,21-03-2020,2,19,0,0
10,22-03-2020,0,19,0,0
11,23-03-2020,1,20,0,0
12,24-03-2020,1,21,0,0
13,25-03-2020,14,35,0,0
14,26-03-2020,1,36,0,0
15,27-03-2020,3,39,1,1
16,28-03-2020,25,64,0,1
17,29-03-2020,8,72,0,1
18,30-03-2020,24,96,0,1
19,31-03-2020,7,103,0,1
20,01-04-2020,24,127,0,1
21,02-04-2020,40,167,0,1
22,03-04-2020,15,182,1,2
23,04-04-2020,12,194,0,2
24,05-04-2020,9,203,0,2
25,06-04-2020,1,204,0,2
26,07-04-2020,13,217,1,3
27,08-04-2020,4,221,0,3
28,09-04-2020,3,224,0,3
29,10-04-2020,6,230,1,4
30,11-04-2020,12,242,0,4
31,12-04-2020,0,242,0,4
32,13-04-2020,2,244,0,4
33,14-04-2020,0,244,0,4
34,15-04-2020,2,246,1,5
35,16-04-2020,4,250,0,5
36,17-04-2020,0,250,0,5
37,18-04-2020,3,253,0,5
38,19-04-2020,0,253,0,5
39,20-04-2020,1,254,1,6
40,21-04-2020,1,255,0,6
41,22-04-2020,2,257,0,6
42,23-04-2020,5,262,0,6
43,24-04-2020,1,263,0,6
44,25-04-2020,4,267,0,6
45,26-04-2020,4,271,0,6
46,27-04-2020,1,272,0,6
47,28-04-2020,0,272,0,6
48,29-04-2020,1,273,0,6
49,30-04-2020,2,275,0,6
50,01-05-2020,4,279,0,6
51,02-05-2020,0,279,0,6
52,03-05-2020,1,280,0,6
53,04-05-2020,0,280,0,6
54,05-05-2020,1,281,1,7
55,06-05-2020,2,283,0,7
56,07-05-2020,0,283,0,7
57,08-05-2020,1,284,0,7
58,09-05-2020,0,284,0,7
59,10-05-2020,3,287,0,7
60,11-05-2020,2,289,0,7
61,12-05-2020,0,289,0,7
62,13-05-2020,0,289,0,7
63,14-05-2020,0,289,0,7
64,15-05-2020,0,289,0,7
65,16-05-2020,0,289,0,7
66,17-05-2020,0,289,0,7
67,18-05-2020,1,290,0,7
68,19-05-2020,0,290,0,7
69,20-05-2020,0,290,0,7
70,21-05-2020,0,290,0,7
71,22-05-2020,2,292,0,7
72,23-05-2020,0,292,0,7
73,24-05-2020,0,292,0,7
74,25-05-2020,0,292,0,7
75,26-05-2020,0,292,0,7
76,27-05-2020,0,292,0,7
77,28-05-2020,2,294,0,7
78,29-05-2020,0,294,0,7
79,30-05-2020,0,294,0,7
80,31-05-2020,1,295,0,7
81,01-06-2020,0,295,0,7
82,02-06-2020,2,297,0,7
83,03-06-2020,1,298,0,7
84,04-06-2020,0,298,0,7
85,05-06-2020,2,300,0,7
86,06-06-2020,0,300,0,7
87,07-06-2020,0,300,0,7
88,08-06-2020,0,300,0,7
89,09-06-2020,0,300,0,7
90,10-06-2020,0,300,0,7
91,11-06-2020,0,300,0,7
92,12-06-2020,1,301,0,7
93,13-06-2020,2,303,0,7
94,14-06-2020,1,304,0,7
95,15-06-2020,0,304,0,7
96,16-06-2020,0,304,0,7
97,17-06-2020,2,306,0,7
98,18-06-2020,2,308,0,7
99,19-06-2020,3,311,0,7
100,20-06-2020,2,313,0,7
101,21-06-2020,0,313,0,7
102,22-06-2020,1,314,0,7
103,23-06-2020,0,314,0,7
104,24-06-2020,1,315,0,7
105,25-06-2020,1,316,0,7
106,26-06-2020,2,318,0,7
107,27-06-2020,4,322,0,7
108,28-06-2020,0,322,0,7
109,29-06-2020,2,324,0,7
110,30-06-2020,1,325,0,7
111,01-07-2020,0,325,0,7
112,02-07-2020,0,325,0,7
113,03-07-2020,0,325,0,7
114,04-07-2020,0,325,0,7
115,05-07-2020,0,325,0,7
116,06-07-2020,0,325,0,7
117,07-07-2020,0,325,0,7
118,08-07-2020,0,325,0,7
119,09-07-2020,0,325,0,7
120,10-07-2020,0,325,0,7
121,11-07-2020,0,325,0,7
122,12-07-2020,0,325,0,7
123,13-07-2020,0,325,0,7
124,14-07-2020,5,330,0,7
125,15-07-2020,0,330,0,7
126,16-07-2020,1,331,0,7
127,17-07-2020,5,336,0,7
128,18-07-2020,0,336,0,7
129,19-07-2020,0,336,0,7
130,20-07-2020,18,354,0,7
131,21-07-2020,12,366,0,7
132,22-07-2020,8,374,0,7
133,23-07-2020,1,375,0,7
134,24-07-2020,9,384,0,7
135,25-07-2020,0,384,0,7
136,26-07-2020,0,384,0,7
137,27-07-2020,15,399,0,7
138,28-07-2020,5,404,1,8
139,29-07-2020,3,407,0,8
140,30-07-2020,2,409,0,8
141,31-07-2020,6,415,0,8
142,01-08-2020,0,415,0,8
143,02-08-2020,0,415,0,8
144,03-08-2020,0,415,0,8
145,04-08-2020,27,442,0,8
146,05-08-2020,2,444,0,8
147,06-08-2020,30,474,0,8
148,07-08-2020,17,491,0,8
149,08-08-2020,16,507,0,8
150,09-08-2020,35,542,0,8
151,10-08-2020,16,558,0,8
152,11-08-2020,4,562,0,8
153,12-08-2020,16,578,0,8
154,13-08-2020,25,603,0,8
155,14-08-2020,40,643,0,8
156,15-08-2020,17,660,1,9
157,16-08-2020,36,696,0,9
158,17-08-2020,34,730,0,9
159,18-08-2020,17,747,2,11
160,19-08-2020,15,762,1,12
161,20-08-2020,33,795,0,12
162,21-08-2020,34,829,0,12
163,22-08-2020,42,871,0,12
164,23-08-2020,72,943,0,12
165,24-08-2020,49,992,0,12
166,25-08-2020,25,1017,1,13
167,26-08-2020,25,1042,0,13
168,27-08-2020,22,1064,1,14
169,28-08-2020,32,1096,0,14
170,29-08-2020,55,1151,0,14
171,30-08-2020,34,1185,0,14
172,31-08-2020,28,1213,0,14
173,01-09-2020,18,1231,0,14
174,02-09-2020,13,1244,0,14
175,03-09-2020,20,1264,2,16
176,04-09-2020,9,1273,0,16
177,05-09-2020,21,1294,0,16
178,06-09-2020,28,1322,0,16
179,07-09-2020,15,1337,0,16
180,08-09-2020,11,1348,0,16
181,09-09-2020,15,1363,0,16
182,10-09-2020,15,1378,0,16
183,11-09-2020,15,1393,0,16
184,12-09-2020,17,1410,0,16
185,13-09-2020,18,1428,0,16
186,14-09-2020,21,1449,0,16
187,15-09-2020,17,1466,0,16
188,16-09-2020,23,1489,0,16
189,17-09-2020,11,1500,0,16
190,18-09-2020,40,1540,0,16
191,19-09-2020,17,1557,0,16
192,20-09-2020,29,1586,0,16
193,21-09-2020,22,1608,2,18
194,22-09-2020,24,1632,0,18
195,23-09-2020,42,1674,0,18
196,24-09-2020,36,1710,1,19
197,25-09-2020,54,1764,0,19
198,26-09-2020,65,1829,0,19
199,27-09-2020,51,1880,0,19
200,28-09-2020,39,1919,1,20
201,29-09-2020,34,1953,0,20
202,30-09-2020,40,1993,0,20
203,01-10-2020,36,2029,0,20
204,02-10-2020,39,2068,1,21
205,03-10-2020,36,2104,1,22
206,04-10-2020,35,2139,1,23
207,05-10-2020,51,2190,0,23
208,06-10-2020,56,2246,1,24
209,07-10-2020,31,2277,3,27
210,08-10-2020,67,2344,0,27
211,09-10-2020,84,2428,3,30
212,10-10-2020,96,2524,2,32
213,11-10-2020,54,2578,0,32
214,12-10-2020,77,2655,2,34
215,13-10-2020,124,2779,1,35
216,14-10-2020,146,2925,2,37
217,15-10-2020,173,3098,1,38
218,16-10-2020,75,3173,0,38
219,17-10-2020,85,3258,0,38
220,18-10-2020,44,3302,2,40
221,19-10-2020,79,3381,2,42
222,20-10-2020,110,3491,0,42
223,21-10-2020,135,3626,1,43
224,22-10-2020,147,3773,4,47
225,23-10-2020,162,3935,1,48
226,24-10-2020,153,4088,2,50
227,25-10-2020,161,4249,4,54
228,26-10-2020,99,4348,1,55
229,27-10-2020,183,4531,3,58
230,28-10-2020,170,4701,3,61
231,29-10-2020,193,4894,1,62
232,30-10-2020,480,5374,3,65
233,31-10-2020,348,5722,4,69
234,01-11-2020,312,6034,6,75
235,02-11-2020,241,6275,5,80
236,03-11-2020,102,6377,5,85
237,04-11-2020,373,6750,2,87
238,05-11-2020,426,7176,4,91
239,06-11-2020,242,7418,5,96
240,07-11-2020,271,7689,7,103
241,08-11-2020,441,8130,3,106
242,09-11-2020,365,8495,3,109
243,10-11-2020,382,8877,5,114
244,11-11-2020,431,9308,9,123
245,12-11-2020,471,9779,9,132
246,13-11-2020,435,10214,5,137
247,14-11-2020,239,10453,15,152
248,15-11-2020,494,10947,10,162
249,16-11-2020,391,11338,10,172
250,17-11-2020,269,11607,7,179
251,18-11-2020,400,12007,11,190
252,19-11-2020,474,12481,8,198
253,20-11-2020,436,12917,9,207
254,21-11-2020,384,13301,10,217
255,22-11-2020,240,13541,12,229
256,23-11-2020,541,14082,6,235
257,24-11-2020,476,14558,12,247
258,25-11-2020,347,14905,9,256
259,26-11-2020,383,15288,10,266
260,27-11-2020,343,15631,14,280
261,28-11-2020,487,16118,10,290
262,29-11-2020,364,16482,11,301
263,30-11-2020,342,16824,11,312
264,01-12-2020,283,17107,16,328
265,02-12-2020,277,17384,14,342
266,03-12-2020,365,17749,12,354
267,04-12-2020,320,18069,9,363
268,05-12-2020,354,18423,19,382
269,06-12-2020,383,18806,13,395
270,07-12-2020,325,19131,12,407
271,08-12-2020,245,19376,13,420
272,09-12-2020,278,19654,18,438
273,10-12-2020,291,19945,13,451
274,11-12-2020,445,20390,14,465
275,12-12-2020,360,20750,18,483
276,13-12-2020,273,21023,7,490
277,14-12-2020,240,21263,9,499
278,15-12-2020,271,21534,9,508
279,16-12-2020,292,21826,15,523
280,17-12-2020,221,22047,14,537
281,18-12-2020,345,22392,10,547
282,19-12-2020,236,22628,8,555
283,20-12-2020,229,22857,13,568
284,21-12-2020,166,23023,4,572
285,22-12-2020,155,23178,18,590
286,23-12-2020,200,23378,15,605
287,24-12-2020,241,23619,12,617
288,25-12-2020,0,23619,0,617
289,26-12-2020,0,23619,0,617
290,27-12-2020,524,24143,28,645
291,28-12-2020,107,24250,9,654
292,29-12-2020,131,24381,5,659
293,30-12-2020,130,24511,2,661
294,31-12-2020,186,24697,6,667
295,01-01-2021,0,24697,0,667
296,02-01-2021,326,25023,11,678
297,03-01-2021,101,25124,5,683
298,04-01-2021,118,25242,5,688
299,05-01-2021,121,25363,7,695
300,06-01-2021,169,25532,10,705
301,07-01-2021,207,25739,12,717
302,08-01-2021,222,25961,9,726
303,09-01-2021,203,26164,7,733
304,10-01-2021,151,26315,4,737
305,11-01-2021,131,26446,3,740
306,12-01-2021,89,26535,7,747
307,13-01-2021,156,26691,5,752
308,14-01-2021,261,26952,2,754
309,15-01-2021,188,27140,4,758
310,16-01-2021,180,27320,2,760
311,17-01-2021,189,27509,7,767
312,18-01-2021,118,27627,3,770
313,19-01-2021,110,27737,11,781
314,20-01-2021,152,27889,6,787
315,21-01-2021,196,28085,4,791
316,22-01-2021,173,28258,2,793
317,23-01-2021,215,28473,3,796
318,24-01-2021,222,28695,3,799
319,25-01-2021,111,28806,5,804
320,26-01-2021,93,28899,5,809
321,27-01-2021,94,28993,4,813
322,28-01-2021,128,29121,7,820
323,29-01-2021,157,29278,3,823
324,30-01-2021,165,29443,2,825
325,31-01-2021,117,29560,4,829
326,01-02-2021,88,29648,3,832
327,02-02-2021,82,29730,0,832
328,03-02-2021,126,29856,3,835
329,04-02-2021,110,29966,2,837
330,05-02-2021,108,30074,1,838
331,06-02-2021,81,30155,4,842
332,07-02-2021,79,30234,4,846
333,08-02-2021,49,30283,4,850
334,09-02-2021,73,30356,3,853
335,10-02-2021,59,30415,6,859
336,11-02-2021,90,30505,3,862
337,12-02-2021,80,30585,4,866
338,13-02-2021,99,30684,1,867
339,14-02-2021,79,30763,5,872
340,15-02-2021,0,30763,0,872
341,16-02-2021,166,30929,3,875
342,17-02-2021,75,31004,2,877
343,18-02-2021,139,31143,1,878
344,19-02-2021,91,31234,1,879
345,20-02-2021,94,31328,3,882
346,21-02-2021,58,31386,2,884
347,22-02-2021,89,31475,2,886
348,23-02-2021,70,31545,0,886
349,24-02-2021,42,31587,1,887
350,25-02-2021,70,31657,1,888
351,26-02-2021,62,31719,1,889
352,27-02-2021,90,31809,4,893
353,28-02-2021,50,31859,2,895
354,01-03-2021,27,31886,1,896
355,02-03-2021,63,31949,2,898
356,03-03-2021,51,32000,3,901
357,04-03-2021,50,32050,2,903
358,05-03-2021,49,32099,1,904
359,06-03-2021,70,32169,1,905
360,07-03-2021,56,32225,1,906
361,08-03-2021,59,32284,1,907
362,09-03-2021,60,32344,0,907
363,10-03-2021,74,32418,1,908
364,11-03-2021,85,32503,3,911
365,12-03-2021,102,32605,1,912
366,13-03-2021,94,32699,4,916
367,14-03-2021,44,32743,1,917
368,15-03-2021,49,32792,0,917
369,16-03-2021,108,32900,0,917
370,17-03-2021,94,32994,0,917
371,18-03-2021,89,33083,1,918
372,19-03-2021,91,33174,1,919
373,20-03-2021,89,33263,1,920
374,21-03-2021,89,33352,7,927
375,22-03-2021,61,33413,1,928
376,23-03-2021,97,33510,0,928
377,24-03-2021,74,33584,0,928
378,25-03-2021,110,33694,1,929
379,26-03-2021,116,33810,3,932
380,27-03-2021,57,33867,1,933
381,28-03-2021,55,33922,1,934
382,29-03-2021,53,33975,0,934
383,30-03-2021,76,34051,0,934
384,31-03-2021,64,34115,1,935
385,01-04-2021,56,34171,2,937
386,02-04-2021,0,34171,0,937
387,03-04-2021,181,34352,1,938
388,04-04-2021,0,34352,0,938
389,05-04-2021,135,34487,2,940
390,06-04-2021,61,34548,2,942
391,07-04-2021,107,34655,1,943
392,08-04-2021,136,34791,3,946
393,09-04-2021,179,34970,2,948
394,10-04-2021,132,35102,1,949
395,11-04-2021,112,35214,0,949
396,12-04-2021,111,35325,0,949
397,13-04-2021,129,35454,2,951
398,14-04-2021,82,35536,3,954
399,15-04-2021,153,35689,1,955
400,16-04-2021,121,35810,0,955
401,17-04-2021,180,35990,3,958
402,18-04-2021,170,36160,1,959
403,19-04-2021,100,36260,0,959
404,20-04-2021,209,36469,1,960
405,21-04-2021,161,36630,1,961
406,22-04-2021,259,36889,1,962
407,23-04-2021,175,37064,2,964
408,24-04-2021,276,37340,3,967
409,25-04-2021,259,37599,0,967
410,26-04-2021,209,37808,1,968
411,27-04-2021,215,38023,0,968
412,28-04-2021,187,38210,3,971
413,29-04-2021,225,38435,2,973
414,30-04-2021,288,38723,1,974
415,01-05-2021,271,38994,2,976
416,02-05-2021,280,39274,2,978
417,03-05-2021,250,39524,1,979
418,04-05-2021,290,39814,1,980
419,05-05-2021,265,40079,2,982
420,06-05-2021,359,40438,4,986
421,07-05-2021,499,40937,1,987
422,08-05-2021,483,41420,3,990
423,09-05-2021,529,41949,3,993
424,10-05-2021,501,42450,4,997
425,11-05-2021,329,42779,0,997
426,12-05-2021,361,43140,2,999
427,13-05-2021,558,43698,3,1002
428,14-05-2021,489,44187,0,1002
429,15-05-2021,428,44615,4,1006
430,16-05-2021,534,45149,4,1010
431,17-05-2021,429,45578,1,1011
432,18-05-2021,334,45912,1,1012
433,19-05-2021,401,46313,4,1016
434,20-05-2021,597,46910,3,1019
435,21-05-2021,591,47501,3,1022
436,22-05-2021,474,47975,6,1028
437,23-05-2021,459,48434,1,1029
438,24-05-2021,353,48787,4,1033
439,25-05-2021,257,49044,1,1034
440,26-05-2021,310,49354,0,1034
441,27-05-2021,293,49647,8,1042
442,28-05-2021,495,50142,0,1042
443,29-05-2021,356,50498,3,1045
444,30-05-2021,289,50787,7,1052
445,31-05-2021,303,51090,1,1053
446,01-06-2021,226,51316,3,1056
447,02-06-2021,264,51580,6,1062
448,03-06-2021,355,51935,5,1067
449,04-06-2021,326,52261,4,1071
450,05-06-2021,270,52531,1,1072
451,06-06-2021,220,52751,3,1075
452,07-06-2021,168,52919,2,1077
453,08-06-2021,234,53153,2,1079
454,09-06-2021,250,53403,2,1081
455,10-06-2021,247,53650,6,1087
456,11-06-2021,222,53872,2,1089
457,12-06-2021,291,54163,4,1093
458,13-06-2021,194,54357,7,1100
459,14-06-2021,124,54481,2,1102
460,15-06-2021,115,54596,2,1104
461,16-06-2021,143,54739,7,1111
462,17-06-2021,176,54915,1,1112
463,18-06-2021,183,55098,3,1115
464,19-06-2021,140,55238,3,1118
465,20-06-2021,93,55331,6,1124
466,21-06-2021,74,55405,1,1125
467,22-06-2021,62,55467,4,1129
468,23-06-2021,122,55589,3,1132
469,24-06-2021,103,55692,2,1134
470,25-06-2021,85,55777,1,1135
471,26-06-2021,102,55879,3,1138
472,27-06-2021,96,55975,1,1139
473,28-06-2021,61,56036,0,1139
474,29-06-2021,61,56097,0,1139
475,30-06-2021,70,56167,2,1141
476,01-07-2021,0,56167,0,1141
477,02-07-2021,139,56306,6,1147
478,03-07-2021,47,56353,1,1148
479,04-07-2021,64,56417,2,1150
480,05-07-2021,65,56482,1,1151
481,06-07-2021,34,56516,1,1152
482,07-07-2021,70,56586,2,1154
483,08-07-2021,81,56667,3,1157
484,09-07-2021,72,56739,3,1160
485,10-07-2021,87,56826,0,1160
486,11-07-2021,63,56889,1,1161
487,12-07-2021,31,56920,1,1162
488,13-07-2021,23,56943,1,1163
489,14-07-2021,44,56987,0,1163
490,15-07-2021,41,57028,1,1164
491,16-07-2021,37,57065,0,1164
492,17-07-2021,61,57126,0,1164
493,18-07-2021,42,57168,1,1165
494,19-07-2021,36,57204,0,1165
495,20-07-2021,32,57236,0,1165
496,21-07-2021,33,57269,1,1166
497,22-07-2021,53,57322,1,1167
498,23-07-2021,37,57359,3,1170
499,24-07-2021,58,57417,1,1171
500,25-07-2021,29,57446,1,1172
501,26-07-2021,10,57456,0,1172
502,27-07-2021,20,57476,0,1172
503,28-07-2021,26,57502,3,1175
504,29-07-2021,46,57548,2,1177
505,30-07-2021,45,57593,1,1178
506,31-07-2021,0,57593,0,1178
507,01-08-2021,0,57593,0,1178
508,02-08-2021,0,57593,0,1178
509,03-08-2021,98,57691,3,1181
510,04-08-2021,15,57706,0,1181
511,05-08-2021,33,57739,2,1183
512,06-08-2021,25,57764,1,1184
513,07-08-2021,0,57764,0,1184
514,08-08-2021,0,57764,0,1184
515,09-08-2021,96,57860,0,1184
516,10-08-2021,31,57891,0,1184
517,11-08-2021,32,57923,-1,1183
518,12-08-2021,28,57951,1,1184
519,13-08-2021,21,57972,1,1185
520,14-08-2021,0,57972,0,1185
521,15-08-2021,0,57972,0,1185
522,16-08-2021,77,58049,2,1187
523,17-08-2021,22,58071,1,1188
524,18-08-2021,37,58108,0,1188
525,19-08-2021,26,58134,0,1188
526,20-08-2021,42,58176,0,1188
527,21-08-2021,0,58176,0,1188
528,22-08-2021,0,58176,0,1188
529,23-08-2021,107,58283,0,1188
530,24-08-2021,39,58322,0,1188
531,25-08-2021,103,58425,1,1189
532,26-08-2021,54,58479,0,1189
533,27-08-2021,27,58506,0,1189
534,28-08-2021,0,58506,0,1189
535,29-08-2021,0,58506,0,1189
536,30-08-2021,175,58681,0,1189
537,31-08-2021,29,58710,0,1189
538,01-09-2021,49,58759,1,1190
539,02-09-2021,34,58793,2,1192
540,03-09-2021,52,58845,0,1192
541,04-09-2021,0,58845,0,1192
542,05-09-2021,0,58845,0,1192
543,06-09-2021,0,58845,0,1192
544,07-09-2021,155,59000,6,1198
545,08-09-2021,52,59052,0,1198
546,09-09-2021,48,59100,1,1199
547,10-09-2021,103,59203,1,1200
548,11-09-2021,0,59203,0,1200
549,12-09-2021,0,59203,0,1200
550,13-09-2021,165,59368,2,1202
551,14-09-2021,52,59420,-1,1201
552,15-09-2021,46,59466,2,1203
553,16-09-2021,60,59526,0,1203
554,17-09-2021,86,59612,1,1204
555,18-09-2021,0,59612,0,1204
556,19-09-2021,0,59612,0,1204
557,20-09-2021,147,59759,1,1205
558,21-09-2021,63,59822,1,1206
559,22-09-2021,58,59880,1,1207
560,23-09-2021,64,59944,0,1207
561,24-09-2021,56,60000,0,1207
562,25-09-2021,0,60000,0,1207
563,26-09-2021,0,60000,0,1207
564,27-09-2021,294,60294,2,1209
565,28-09-2021,39,60333,2,1211
566,29-09-2021,110,60443,0,1211
567,30-09-2021,0,60443,0,1211
568,01-10-2021,185,60628,0,1211
569,02-10-2021,0,60628,0,1211
570,03-10-2021,0,60628,0,1211
571,04-10-2021,315,60943,2,1213
572,05-10-2021,95,61038,0,1213
573,06-10-2021,88,61126,1,1214
574,07-10-2021,131,61257,1,1215
575,08-10-2021,128,61385,2,1217
576,09-10-2021,0,61385,0,1217
577,10-10-2021,0,61385,0,1217
578,11-10-2021,0,61385,0,1217
579,12-10-2021,336,61721,7,1224
580,13-10-2021,75,61796,0,1224
581,14-10-2021,104,61900,2,1226
582,15-10-2021,87,61987,4,1230
583,16-10-2021,0,61987,0,1230
584,17-10-2021,0,61987,0,1230
585,18-10-2021,243,62230,1,1231
586,19-10-2021,102,62332,3,1234
587,20-10-2021,51,62383,1,1235
588,21-10-2021,86,62469,0,1235
589,22-10-2021,119,62588,0,1235
590,23-10-2021,0,62588,0,1235
591,24-10-2021,0,62588,0,1235
592,25-10-2021,319,62907,2,1237
593,26-10-2021,70,62977,0,1237
594,27-10-2021,122,63099,3,1240
595,28-10-2021,113,63212,4,1244
596,29-10-2021,141,63353,2,1246
597,30-10-2021,0,63353,0,1246
598,31-10-2021,0,63353,0,1246
599,01-11-2021,335,63688,2,1248
600,02-11-2021,121,63809,1,1249
601,03-11-2021,122,63931,2,1251
602,04-11-2021,152,64083,2,1253
603,05-11-2021,126,64209,3,1256
604,06-11-2021,0,64209,0,1256
605,07-11-2021,0,64209,0,1256
606,08-11-2021,492,64701,6,1262
607,09-11-2021,177,64878,4,1266
608,10-11-2021,139,65017,2,1268
609,11-11-2021,0,65017,0,1268
610,12-11-2021,354,65371,1,1269
611,13-11-2021,0,65371,0,1269
612,14-11-2021,0,65371,0,1269
613,15-11-2021,392,65763,4,1273
614,16-11-2021,93,65856,1,1274
615,17-11-2021,153,66009,2,1276
616,18-11-2021,175,66184,5,1281
617,19-11-2021,194,66378,4,1285
618,20-11-2021,0,66378,0,1285
619,21-11-2021,0,66378,0,1285
620,22-11-2021,448,66826,7,1292
621,23-11-2021,126,66952,4,1296
622,24-11-2021,140,67092,3,1299
623,25-11-2021,183,67275,5,1304
624,26-11-2021,145,67420,1,1305
625,27-11-2021,0,67420,0,1305
626,28-11-2021,0,67420,0,1305
627,29-11-2021,333,67753,10,1315
628,30-11-2021,124,67877,4,1319
629,01-12-2021,122,67999,2,1321
630,02-12-2021,167,68166,3,1324
631,03-12-2021,142,68308,4,1328
632,04-12-2021,0,68308,0,1328
633,05-12-2021,0,68308,0,1328
634,06-12-2021,537,68845,6,1334
635,07-12-2021,93,68938,4,1338
636,08-12-2021,175,69113,3,1341
637,09-12-2021,201,69314,3,1344
638,10-12-2021,193,69507,1,1345
639,11-12-2021,0,69507,0,1345
640,12-12-2021,0,69507,0,1345
641,13-12-2021,472,69979,8,1353
642,14-12-2021,161,70140,2,1355
643,15-12-2021,200,70340,2,1357
644,16-12-2021,211,70551,2,1359
645,17-12-2021,234,70785,1,1360
646,18-12-2021,0,70785,0,1360
647,19-12-2021,0,70785,0,1360
648,20-12-2021,805,71590,6,1366
649,21-12-2021,298,71888,0,1366
650,22-12-2021,395,72283,2,1368
651,23-12-2021,551,72834,1,1369
652,24-12-2021,739,73573,1,1370
653,25-12-2021,0,73573,0,1370
654,26-12-2021,0,73573,0,1370
655,27-12-2021,2144,75717,8,1378
656,28-12-2021,822,76539,5,1383
657,29-12-2021,946,77485,1,1384
658,30-12-2021,1121,78606,3,1387
659,31-12-2021,1490,80096,5,1392
660,01-01-2022,0,80096,0,1392
661,02-01-2022,0,80096,0,1392
662,03-01-2022,5411,85507,6,1398
663,04-01-2022,1756,87263,2,1400
664,05-01-2022,1787,89050,2,1402
665,06-01-2022,2537,91587,6,1408
666,07-01-2022,3263,94850,0,1408
667,08-01-2022,0,94850,0,1408
668,09-01-2022,0,94850,0,1408
669,10-01-2022,7083,101933,19,1427
670,11-01-2022,2002,103935,-1,1426
671,12-01-2022,1471,105406,3,1429
672,13-01-2022,1221,106627,9,1438
673,14-01-2022,1211,107838,5,1443
674,15-01-2022,0,107838,0,1443
675,16-01-2022,0,107838,0,1443
676,17-01-2022,2755,110593,20,1463
